11, 11, 11, 11, 11, 11, 11, 11, 11, 11, 11, d1, d1, 11, 11, 11, 11, 11, 11, 11, 11, 11, 11, 11, 11, 11, 11, 11, 11, 11, 11, 11
11, 01, 01, 01, 01, 01, 01, 01, 01, 01, 11, 01, 01, 01, 01, 01, 11, 01, 01, 01, 01, 01, 01, 01, 01, 01, 01, 01, 01, 01, 01, 11
11, 01, 01, 01, 01, 01, 01, 01, 01, 01, 11, 01, 01, 01, 01, 01, 11, 01, 01, 01, 01, 01, 01, 01, 01, 01, 01, 01, 01, 01, 01, 11
11, 01, 01, 01, 01, 11, 01, 01, 01, 01, 11, 11, 11, 11, 01, 01, 11, 01, 01, 01, 01, 01, 01, 01, 01, 01, 01, 01, 01, 01, 01, 11
11, 01, 01, 01, 01, 11, 01, 01, 01, 01, 01, 01, 01, 11, 01, 01, 11, 01, 01, 01, 01, 01, 01, 01, 01, 01, 01, 01, 11, 11, 01, 11
11, 01, 01, 01, 01, 11, 01, 01, 01, 01, 01, 01, 01, 01, 01, 01, 11, 01, 01, 01, 01, 01, 01, 01, 01, 01, 01, 01, 11, 01, 01, 11
11, 11, 11, 01, 01, 11, 01, 01, 01, 01, 01, 01, 01, 01, 01, 01, 01, 01, 01, 01, 01, 01, 01, 01, 01, 01, 01, 01, 11, 01, 01, 11
d1, 01, 01, 01, 01, 11, 01, 01, 01, 01, 01, 01, 01, 01, 01, 01, 01, 01, 01, 01, 01, 01, 01, 01, 01, 01, 01, 01, 01, 01, 01, 11
d1, 01, 01, 01, 01, 11, 01, 01, 01, 01, 01, 01, 01, 01, 01, 01, 01, 01, 01, 01, 01, 01, 01, 01, 11, 11, 01, 01, 01, 01, 01, d1
11, 11, 11, 01, 01, 11, 01, 01, 01, 01, 01, 01, 01, 01, 01, 11, 01, 01, 01, 01, 01, 01, 01, 01, 01, 01, 01, 01, 01, 01, 01, d1
11, 01, 01, 01, 01, 11, 01, 01, 01, 01, 01, 01, 01, 01, 01, 11, 01, 01, 01, 01, 01, 01, 01, 01, 01, 01, 01, 01, 11, 01, 01, 11
11, 01, 01, 01, 01, 11, 01, 01, 01, 01, 01, 01, 01, 01, 01, 11, 01, 01, 01, 01, 01, 01, 01, 01, 01, 01, 01, 01, 11, 01, 01, 11
11, 01, 01, 01, 01, 11, 01, 01, 01, 01, 01, 11, 11, 11, 11, 01, 01, 01, 01, 01, 01, 01, 01, 01, 01, 01, 01, 01, 11, 11, 01, 11
11, 01, 01, 01, 01, 01, 01, 01, 01, 01, 01, 01, 01, 01, 01, 11, 01, 01, 01, 01, 01, 01, 01, 01, 01, 01, 01, 01, 01, 01, 01, 11
11, 01, 01, 01, 01, 01, 01, 01, 01, 01, 01, 01, 01, 01, 01, 11, 01, 01, 01, 01, 01, 01, 01, 01, 01, 01, 01, 01, 01, 01, 01, 11
11, 11, 11, 11, 11, 11, 11, 11, 11, 11, 11, 11, d1, d1, 11, 11, 11, 11, 11, 11, 11, 11, 11, 11, 11, 11, 11, 11, 11, 11, 11, 11